----------------------------------------------
|                                            |
|   ------------------                       |
|   |................|        -------------  |
|   |................|        |...........|  |
|   |................|        |...........|  |
|   -------------+----        |...........|  |
|                #            ---+---------  |
|     -------    #################           |
|     |.....|    ----------------+--- ------ |
|     |.....|    |..................| |....| |
|     |.....+####+..................| |....| |
|     |.....|    |..................+#+....| |
|     -------    |..................| |....| |
|                |..................| |....| |
|                |..................| ------ |
|                --------------------        |
----------------------------------------------